
      #######
  ### #F #  #              ####
  # ###  #  #              #  #
  #     ## #################  #
  #         #               S #
 ##  #####  # #############   #
 #   #   # ## #           #   #
 #   #   #    #           #####
 #####   ######




