
      #######
  ### #A #  #              ####
  # ###  #  #              #  #
  #     ## #################  #
  #         #               B #
 ##  #####  # #############   #
 #   #   # ## #           #   #
 #   #   #    #           #####
 #####   ######




