##############
#   #********#
# S #* #####*#
# **** #  ##*#
######### #**#
#       *F#*##
# ######* #**#
#   #  #*###*#
#   #   *****#
##############
