##############
#   #        #
# S #  ##### #
#      #  ## #
######### #  #
#        F# ##
# ######  #  #
#   #  # ### #
#   #        #
##############
