##############
#   #        #
# S #        #
#      #     #
##########   #
#       #F# ##
# #########  #
#   #  #     #
#   #        #
##############
