##############
#   #        #
# A #    A   #
#      #     #
##########   #
#        B# ##
# #####   #  #
#   #  #     #
#   #        #
##############