##############
#   #        #
# S #    S   #
#      #     #
##########   #
#        F# ##
# #####   #  #
#   #  #     #
#   #        #
##############