##############
#   #        #
# A #        #
#      #     #
##########   #
#       #B# ##
# #########  #
#   #  #     #
#   #        #
##############
